[
  {
    "type": "overmap_terrain",
    "id": "survivor_base",
    "name": "survivor farmhouse",
    "sym": 72,
    "color": "pink",
    "see_cost": 2,
    "flags": [ "KNOWN_UP", "NO_ROTATE" ]
  },
  {
    "type": "overmap_terrain",
    "id": "survivor_base_roof",
    "name": "survivor farmhouse",
    "sym": 104,
    "color": "pink",
    "see_cost": 2,
    "flags": [ "KNOWN_DOWN", "NO_ROTATE" ]
  },
  {
    "type": "overmap_terrain",
    "id": "survivor_barn",
    "name": "survivor garage",
    "sym": 103,
    "color": "cyan",
    "see_cost": 2,
    "flags": [ "KNOWN_UP", "NO_ROTATE" ]
  },
  {
    "type": "overmap_terrain",
    "id": "survivor_barn_roof",
    "name": "survivor barn",
    "sym": 103,
    "color": "cyan",
    "see_cost": 2,
    "flags": [ "KNOWN_DOWN", "NO_ROTATE" ]
  },
  {
    "type": "overmap_terrain",
    "id": "survivor_field_ne",
    "name": "survivor field",
    "sym": 102,
    "color": "light_green",
    "see_cost": 2,
    "flags": [ "NO_ROTATE" ]
  },
  {
    "type": "overmap_terrain",
    "id": "survivor_field_nw",
    "name": "survivor field",
    "sym": 102,
    "color": "light_green",
    "see_cost": 2,
    "flags": [ "NO_ROTATE" ]
  },
  {
    "type": "overmap_special",
    "id": "survivor_farm_base",
    "overmaps": [
      { "point": [ 0, 0, 0 ], "overmap": "survivor_base" },
      { "point": [ 0, 0, 1 ], "overmap": "survivor_base_roof" },
      { "point": [ -1, 0, 0 ], "overmap": "survivor_barn" },
      { "point": [ -1, 0, 1 ], "overmap": "survivor_barn_roof" },
      { "point": [ 0, -1, 0 ], "overmap": "survivor_field_ne" },
      { "point": [ -1, -1, 0 ], "overmap": "survivor_field_nw" }
    ],
    "locations": [ "land", "swamp" ],
    "city_distance": [ 7, 20 ],
    "city_sizes": [ 1, 12 ],
    "occurrences": [ 1, 1 ],
    "rotate": false,
    "connections": [ { "point": [ -1, 1, 0 ], "terrain": "road", "existing": false } ],
    "flags": [ "CLASSIC" ]
  },
  {
    "type": "palette",
    "id": "survivor_base_pallete",
    "terrain": {
      ".": "t_grass",
      " ": "t_floor",
      "!": "t_flat_roof",
      "#": "t_dirtmound",
      "%": "t_fence_barbed",
      "+": "t_door_c",
      "_": "t_pavement",
      ",": "t_pavement_y",
      "-": "t_brick_wall",
      "|": "t_brick_wall",
      "*": "t_open_air",
      "~": "t_water_sh",
      "<": "t_stairs_up",
      ">": "t_stairs_down",
      "/": "t_dirt",
      "5": "t_gates_control_brick",
      "6": "t_console",
      ";": "t_dirtfloor",
      "=": "t_door_metal_locked",
      "@": "t_floor",
      "B": "t_floor",
      "C": "t_chainfence",
      "E": "t_floor",
      "F": "t_rootcellar",
      "G": "t_chaingate_c",
      "L": "t_floor",
      "O": "t_floor",
      "P": "t_pit",
      "R": "t_railing",
      "S": "t_floor",
      "T": "t_tree",
      "c": "t_floor",
      "d": "t_floor",
      "f": "t_floor",
      "m": "t_door_metal_c_peep",
      "r": "t_dirtfloor",
      "s": "t_sidewalk",
      "t": "t_floor",
      "w": "t_window_bars",
      "v": "t_window_domestic"
    },
    "furniture": {
      "@": "f_bed",
      "B": "f_bathtub",
      "E": "f_bookcase",
      "L": "f_locker",
      "O": "f_oven",
      "S": "f_sink",
      "c": "f_counter",
      "d": "f_dresser",
      "f": "f_fridge",
      "r": "f_rack",
      "t": "f_toilet"
    },
    "computers": {
      "6": {
        "name": "Barely functional computer",
        "options": [ { "name": "Contact Refugee Center", "action": "emerg_ref_center" } ]
      }
    },
    "toilets": { "t": {  } }
  },
  {
    "type": "mapgen",
    "method": "json",
    "om_terrain": [ [ "survivor_field_nw", "survivor_field_ne" ], [ "survivor_barn", "survivor_base" ] ],
    "weight": 100,
    "object": {
      "faction_owner": [
        { "id": "your_followers", "x": [ 0, 23 ], "y": [ 0, 23 ] },
        { "id": "your_followers", "x": [ 24, 47 ], "y": [ 0, 23 ] },
        { "id": "your_followers", "x": [ 0, 23 ], "y": [ 24, 47 ] },
        { "id": "your_followers", "x": [ 24, 47 ], "y": [ 24, 47 ] }
      ],
      "fill_ter": "t_dirt",
      "rows": [
        "%%%%%%%%%%%%%%%%%%%%%%%%%%%%%%%%%%%%%%%%%%%%%%%%",
        "%PPPPPPPPPPPPPPPPPPPPPPPPPPPPPPPPPPPPPPPPPPPPPP%",
        "%PPPPPPPPPPPPPPPPPPPPPPPPPPPPPPPPPPPPPPPPPPPPPP%",
        "%PP%%%%%%%%%%%%%%%%%%%%%%%%%%%%%%%%%%%%%%%%%%PP%",
        "%PP%........................................%PP%",
        "%PP%........................................%PP%",
        "%PP%........................................%PP%",
        "%PP%........................................%PP%",
        "%PP%......../////////////////////////.......%PP%",
        "%PP%......../##########//###########/.......%PP%",
        "%PP%......../##########//###########/.......%PP%",
        "%PP%......../////////////////////////.......%PP%",
        "%PP%......../##########//###########/.......%PP%",
        "%PP%......../##########//###########/.......%PP%",
        "%PP%......../////////////////////////.......%PP%",
        "%PP%......../##########//###########/.......%PP%",
        "%PP%......../##########//###########/.......%PP%",
        "%PP%......../////////////////////////.......%PP%",
        "%PP%......../##########//###########/.......%PP%",
        "%PP%......../##########//###########/.......%PP%",
        "%PP%......../////////////////////////.......%PP%",
        "%PP%........................................%PP%",
        "%PP%........................................%PP%",
        "%PP%........................................%PP%",
        "%PP%........................................%PP%",
        "%PP---=========-m-.......T.....-------m------PP%",
        "%PP|rr;;;;;;;;;5;|..T..........|EEEE E E  FE|PP%",
        "%PP|;;;;;;;;;;;;;w.........T~~.|           E|PP%",
        "%PP|;;;;;;;;;;;;r|....sssssssss|E           |PP%",
        "%PP|;;;;;;;;;;;;r|<.sssssssssssm            |PP%",
        "%PP|;;;;;;;;;;;;r|sssssssssssss|E           |PP%",
        "%PP|;;;;;;;;;;;;;+sssss_____s~.|c  vvv.vvv  |PP%",
        "%PP|;;;;;;;;;;;;r|sssss_____s~.w   v.....v  |PP%",
        "%PP|r;;;;;;;;;;;r|....s_____s..w   +.....+  |PP%",
        "%PP|r;;;;;;;;;;;;|.T..s_____s..w   v.....v  |PP%",
        "%PP|r;;;;;;;;;;;;w....s_____s..|E  vvv+vvv  |PP%",
        "%PP|r;;;;;;;;;;;;w....s_____s..w            |PP%",
        "%PP|r;;;;;;;;;;;;w....s_____s..|6  fSccO    |PP%",
        "%PP|r;;;;;;;;;;;;w...Ts_____s..|-+---------+|PP%",
        "%PP|r;;;;;;;;;;;;|....s_____s..m  |tS|      |PP%",
        "%PP|r;;;;;;;;;;;;|..T.s_____s..|  |  +   @@ |PP%",
        "%PP|r;;;;;;;;;;;;|...5s_____s..|E |BB|  d@@d|PP%",
        "%PP|;;;;;;;;;;;5;|%%%-=======%%--m-----------PP%",
        "%%%---=========-m-PPP5./////.%PP%.%PPPPPPPPPPPP%",
        "...////////////5P%PPP%./////.%PP%.%PPPPPPPPPPPP%",
        "......///////..%m%%%%%./////.%%%%m%%%%%%%%%%%%%%",
        "..T....///////........../////.................T..",
        "......../////////....//////////////////////......."
      ],
      "palettes": [ "survivor_base_pallete" ],
      "place_vehicles": [
        { "vehicle": "survivor_tractor", "x": 6, "y": 10, "chance": 100, "rotation": 270, "status": 0 },
        { "vehicle": "survivor_home_cart", "x": 5, "y": 29, "chance": 100, "status": 0 },
        { "vehicle": "engine_crane", "x": 7, "y": 29, "chance": 100, "status": 0 },
        { "vehicle": "survivor_weld_cart", "x": 9, "y": 29, "chance": 100, "status": 0 },
        { "vehicle": "survivor_loot_cart", "x": 11, "y": 29, "chance": 100, "status": 0 },
        { "vehicle": "survivor_rv", "x": 10, "y": 38, "chance": 100, "rotation": 270, "status": 0 },
        { "vehicle": "survivor_kitchen", "x": 38, "y": 29, "chance": 100, "rotation": 270, "status": 0 }
      ]
    }
  },
  {
    "type": "mapgen",
    "method": "json",
    "om_terrain": [ [ "survivor_barn_roof", "survivor_base_roof" ] ],
    "weight": 100,
    "object": {
      "fill_ter": "t_dirt",
      "rows": [
        "************************************************",
        "***RRRRRRRRRRRRRRR*************RRRRRRRRRRRRRR***",
        "***R!!!!!!!!!!!!!R*************R!!!!!!!!!!!!R***",
        "***R!!!!!!!!!!!!!R*************R!!!!!!!!!!!!R***",
        "***R!!!!!!!!!!!!!RR************R!!!!!!!!!!!!R***",
        "***R!!!!!!!!!!!!!!>************R!!!!!!!!!!!!R***",
        "***R!!!!!!!!!!!!!RR************R!!!!!!!!!!!!R***",
        "***R!!!!!!!!!!!!!R*************R!!!RRRRRRR!!R***",
        "***R!!!!!!!!!!!!!R*************R!!!R*****R!!R***",
        "***R!CCCCCGC!!!!!R*************R!!!R*****R!!R***",
        "***R!C!!G!!C!!!!!R*************R!!!R*****R!!R***",
        "***R!C!!CCCC!!!!!R*************R!!!RRRRRRR!!R***",
        "***R!C!!!!!C!!!!!R*************R!!!!!!!!!!!!R***",
        "***R!C!!!!!C!!!!!R*************R!!!!!!!!!!!!R***",
        "***R!C!!!!!C!!!!!R*************R!!!!!!!!!!!!R***",
        "***R!C!!!!!C!!!!!R*************R!!!!!!!!!!!!R***",
        "***R!C!!!!!C!!!!!R*************R!!!!!!!!!!!!R***",
        "***R!CCCCCCC!!!!!R*************R!!!!!!!!!!!!R***",
        "***R!!!!!!!!!!!!!R*************RRRRRRRRRRRRRR***",
        "***RRRRRRRRRRRRRRR******************************",
        "************************************************",
        "************************************************",
        "************************************************",
        "************************************************"
      ],
      "palettes": [ "survivor_base_pallete" ]
    }
  }
]
