[
  {
    "type": "palette",
    "id": "bridge_palette",
    "terrain": {
      " ": "t_open_air",
      ".": "t_pavement_bg_dp",
      ":": "t_pavement_y_bg_dp",
      "_": "t_sidewalk_bg_dp",
      "=": "t_guardrail_bg_dp",
      "u": "t_ramp_up_low",
      "U": "t_ramp_up_high",
      "d": "t_ramp_down_high",
      "D": "t_ramp_down_low",
      "L": "t_ladder_up",
      "l": "t_ladder_down",
      "#": "t_wall_r"
    }
  },
  {
    "type": "mapgen",
    "method": "json",
    "om_terrain": [ "bridge" ],
    "object": {
      "fill_ter": "t_water_moving_dp",
      "rows": [
        "~~~~~~~~~~~~~~~~~~~~~~~~",
        "~~~~~~~~~~~~~~~~~~~~~~~~",
        "~~~~~~~~~~~~~~~~~~~~~~~~",
        "~~~~~~~~~~~~~~~~~~~~~~~~",
        "~~~~~~~~~~~~~~~~~~~~~~~~",
        "~~~~~~~~~~~~~~~~~~~~~~~~",
        "~~~~~~~~~~~~~~~~~~~~~~~~",
        "~~~~~~~~~~~~~~~~~~~~~~~~",
        "~~~~~~~~~~~~~~~~~~~~~~~~",
        "~~~~~~~~~~~~~~~~~~~~~~~~",
        "~~~~~~~~~####~~~~~~~~~~~",
        "~~~~~~~~~####~~~~~~~~~~~",
        "~~~~~~~~~####~~~~~~~~~~~",
        "~~~~~~~~~####~~~~~~~~~~~",
        "~~~~~~~~~~~~~~~~~~~~~~~~",
        "~~~~~~~~~~~~~~~~~~~~~~~~",
        "~~~~~~~~~~~~~~~~~~~~~~~~",
        "~~~~~~~~~~~~~~~~~~~~~~~~",
        "~~~~~~~~~~~~~~~~~~~~~~~~",
        "~~~~~~~~~~~~~~~~~~~~~~~~",
        "~~~~~~~~~~~~~~~~~~~~~~~~",
        "~~~~~~~~~~~~~~~~~~~~~~~~",
        "~~~~~~~~~~~~~~~~~~~~~~~~",
        "~~~~~~~~~~~~~~~~~~~~~~~~"
      ],
      "palettes": [ "bridge_palette" ]
    }
  },
  {
    "type": "mapgen",
    "method": "json",
    "om_terrain": [ "bridge_road" ],
    "object": {
      "fill_ter": "t_open_air",
      "rows": [
        "  =_................_=  ",
        "  =_.......::......._=  ",
        "  =_.......::......._=  ",
        "  =_.......::......._=  ",
        "  =_................_=  ",
        "  =_.......::......._=  ",
        "  =_.......::......._=  ",
        "  =_.......::......._=  ",
        "  =_................_=  ",
        "  =_.......::......._=  ",
        "  =_.......::......._=  ",
        "  =_.......::......._=  ",
        "  =_................_=  ",
        "  =_.......::......._=  ",
        "  =_.......::......._=  ",
        "  =_.......::......._=  ",
        "  =_................_=  ",
        "  =_.......::......._=  ",
        "  =_.......::......._=  ",
        "  =_.......::......._=  ",
        "  =_................_=  ",
        "  =_.......::......._=  ",
        "  =_.......::......._=  ",
        "  =_.......::......._=  "
      ],
      "palettes": [ "bridge_palette" ]
    }
  },
  {
    "type": "mapgen",
    "method": "json",
    "om_terrain": [ "bridgehead_ground" ],
    "object": {
      "fill_ter": "t_water_moving_dp",
      "rows": [
        "~~=_................_=~~",
        "~~=_.......::......._=~~",
        "~~=_.......::......._=~~",
        "~~=_.......::......._=~~",
        "~~=_................_=~~",
        "~~=_uuuuuuuuuuuuuuuu_=~~",
        "~~=LUUUUUUUUUUUUUUUUL=~~",
        "~~####################~~",
        "~~~~~~~~~~~~~~~~~~~~~~~~",
        "~~~~~~~~~~~~~~~~~~~~~~~~",
        "~~~~~~~~~####~~~~~~~~~~~",
        "~~~~~~~~~####~~~~~~~~~~~",
        "~~~~~~~~~####~~~~~~~~~~~",
        "~~~~~~~~~####~~~~~~~~~~~",
        "~~~~~~~~~~~~~~~~~~~~~~~~",
        "~~~~~~~~~~~~~~~~~~~~~~~~",
        "~~~~~~~~~~~~~~~~~~~~~~~~",
        "~~~~~~~~~~~~~~~~~~~~~~~~",
        "~~~~~~~~~~~~~~~~~~~~~~~~",
        "~~~~~~~~~~~~~~~~~~~~~~~~",
        "~~~~~~~~~~~~~~~~~~~~~~~~",
        "~~~~~~~~~~~~~~~~~~~~~~~~",
        "~~~~~~~~~~~~~~~~~~~~~~~~",
        "~~~~~~~~~~~~~~~~~~~~~~~~"
      ],
      "palettes": [ "bridge_palette" ]
    }
  },
  {
    "type": "mapgen",
    "method": "json",
    "om_terrain": [ "bridgehead_ramp" ],
    "object": {
      "fill_ter": "t_open_air",
      "rows": [
        "                        ",
        "                        ",
        "                        ",
        "                        ",
        "                        ",
        "  =_DDDDDDDDDDDDDDDD_=  ",
        "  =lddddddddddddddddl=  ",
        "  =_.......::......._=  ",
        "  =_................_=  ",
        "  =_.......::......._=  ",
        "  =_.......::......._=  ",
        "  =_.......::......._=  ",
        "  =_................_=  ",
        "  =_.......::......._=  ",
        "  =_.......::......._=  ",
        "  =_.......::......._=  ",
        "  =_................_=  ",
        "  =_.......::......._=  ",
        "  =_.......::......._=  ",
        "  =_.......::......._=  ",
        "  =_................_=  ",
        "  =_.......::......._=  ",
        "  =_.......::......._=  ",
        "  =_.......::......._=  "
      ],
      "palettes": [ "bridge_palette" ]
    }
  }
]
